WWWWWWWWWWWWW
WWW....WWWWWW
WWW.....WeeeW
WWW.....WeeeW
WeeeW...WeeeW
WeeeW...WeeeW
WeeeW...WeeeW
WeeeW...WeeeW
WeeeW...WeeeW
WeeeW...WeeeW
WWWWWDWWWWWWW

=============

WWWWWWWWWWWWW
WWWWWWWWWWWWW
WWWWWWWWWWWWW
WWWWWWWWWWWWW
WWW........DW
WWW........WW
WWW........WW
WWW........WW
WWWWWWWWWWWWW
WWWWWWWWWWWWW
WWWWWWWWWWWWW